1111110000111111
1000000000000001
1000000000000001
1000000000000001
1000000000000001
1111110000111111 