000000000000000000000
000000000000000000000
000001110000011100000
000001000000000100000
000001000000000100000
000001000000000100000
000001000000000100000
000001000000000100000
000001000000000100000
000001110000011100000
000000000000000000000